为什么	为啥	怎么	如何	咋	是不是	怎么回事	怎么	咋样	什么	请问	怎么办	什么样	不知道	是否	怎样	有何	哪些	问	问题	问一下	多少	为何	怎么样	原因	请问	意思	去哪	吗	么
不能	无法	失败	不会	不	不了	转不了	不可以	不成功	不允许	不到	不行	转不出来	冻结	未成功	无法	买不进	没	没给	未能	还没	没来及	没来得及	转不出	不出	不入	
与	和	也	同	都	跟	此外
假如	如果	若	倘	倘或	倘然	万一	要是
一样	一致
区别	不一样	不同	差异	差别	区分	
三方	第三方
转账	转入	转出	转	转帐	提现	转进	取出
账户	证券	证	钱	资金	证卷	金	款	银证	债券
银行	银行卡	银	农业银行	邮政储蓄银行	农行	
首日	第一天
交易日	交易时间
B股	人民币特种
费用	手续费	免费	收费	开户费	交易费	佣金	资金	钱	费
股票	新股	补仓
创业板	创业版	创业
开	开通	开户	户	开通帐户	加开	办理开户
当日	当天	今天
时间	时候	
忘	忘记	忘了	不记得
帐号	编号	号	客户账户	客户账号	用户账号	交易账号	交易编码	客户号	登陆
看	查询	查	查查
换	更换	更改	变更	改
多少	万几
收	收取
过期	到期
何时	多少时间	几日	多久	几天	几时	时
条件	要求
取消	不想要
请问	问一下	问	问下	问问	咨询	
交易	买卖	买	卖	买入	卖出	卖出去
改	更改	修改	更换	换
深港通	深市港股通
st股	st股票	st	ST
